              =================================              
              ||              1              ||              
              ||      7                8     ||              
              ||                             ||              
              || 5                           ||              
              ||                             ||              
================                             ||              
              ||                             ||              
              || 4                           ||              
              ||                             ||              
================                             ||              
              ||                             ||              
              || 5                           ||              
              ||                             ||              
              ||                             ||              
              ||              c              ||              
              ||                             ||              
              ||                             ||              
              ||                            6||              
              ||                             ||              
              ||                             ================
              ||                             ||              
              ||                           2 ||              
              ||                             ||              
              ||                             ================
              ||                             ||              
              ||                            6||              
              ||                             ||              
              ||              3              ||              
              ||      5                6     ||              
              =================================              
