              =================================              
              ||              1              ||              
              ||      7                8     ||              
              ||                             ||              
              ||                             ||              
              ||                             ||              
              ||                             ||              
              ||                             ||              
              ||                             ||              
              ||                             ||              
              ||                             ||              
              || 5                          6||              
              ||                             ||              
================                             ================
              ||                             ||              
              || 4            c            2 ||              
              ||                             ||              
================                             ================
              ||                             ||              
              || 5                          6||              
              ||                             ||              
              ||                             ||              
              ||                             ||              
              ||                             ||              
              ||                             ||              
              ||                             ||              
              ||                             ||              
              ||                             ||              
              ||              3              ||              
              ||      5                6     ||              
              =================================              
